111111111
110000001
101000001
100000001
100000001
101000001
110000001
111111111