NO ./textures/eagle.xpm
SO ./textures/brick.xpm
WE ./textures/stone.xpm
EA ./textures/wood.xpm
F 91,44,111
C 247,220,111

111111111
110000001
101000001
100010001
100000001
101000N01
110000001
111111111