111111111
100000001
100000001
100N00001
100000001
100000001
100000001
1111111111