F      247   ,   240  ,   111
NO ./textures/eagle.xpm
C 40,20,91
SO ./textures/brick.xpm
WE ./textures/stone.xpm
EA ./textures/wood.xpm

        1111111111111111111111111
        1000000000110000000000001
        1101100000111000000000001
        1001000000000000000000001
111111111011000001110N00000000001
100000000011000001110111111111111
11110111111111011100000010001
11110111111111011101010010001
11000000110101011100000010001
10000000000000001100000010001
10000000000000001101010010001
11000001110101011111011110001
11110111 1110101 101111010001
11111111 1111111 111111111111