F      247   ,   240  ,   111
NO ./textures/eagle.xpm
C 40,20,91
SO ./textures/brick.xpm
WE ./textures/stone.xpm
EA ./textures/wood.xpm

1111111111111111
100110001E001111
1111100000011101          
1100000000000111
1111111011111111
1111111011111111
1000000001000111
1011111111000001
1111   111111111