
SO ./images/bright_green_wall.xpm
WE ./images/dark_green_wall.xpm
NO ./images/sunny_green_wall.xpm
EA ./images/shadow_green_wall.xpm


F 156, 204, 156
C 195, 200, 255

1111111 1111111 1111111 1111111
1000001 1000001 1000001 1000001
1011101 1011101 1011101 1011101
101 101 101 101 101 101 101 101
101 101 101 101 101 101 101 101
101 1011101 1011101 1011101 101
1N1 1000001 1000001 1000001 101
111 1111111 1111111 1111111 101
                            101
111 1111111 1111111 1111111 101
101 1000001 1000001 1000001 101
101 1011101 1011101 1011101 101
101 101 101 101 101 101 101 101
101 101 101 101 101 101 101 101
1011101 1011101 1011101 1011101
1000001 1000001 1000001 1000001
1111111 1111111 1111111 1111111