
SO ./images/bright_green_wall.xpm
WE ./images/dark_green_wall.xpm
NO ./images/sunny_green_wall.xpm
EA ./images/shadow_green_wall.xpm



F 156, 204, 156
C 195, 200, 255

1111
1001
101111111111111111
100000000000000001
10000000000000W001
111111111111111001
              1001
              1111